#################
##M...#......#..#
#...######..###.#
#....#....##.#.##
#.##.L###..##2#.#
##.....###.##.###
#...@...#.M.....#
##L...###..###..#
#..#..#....#...##
#.##.##.#.##.##.#
#.#..#..1##....##
#.#.....##.##...#
#.#######.....L##
#..#...#..#######
#.##.#.#.#......%
#....#.....#.#.##
#################