############%####
###...........##
##1...###.####.##
#.......M#.L..#.#
####....####.####
#.L#......#.....#
##.#####..#.#####
#.M.......#....##
#####L###.####.##
##....#.......###
#...#...###.#..##
##..#.....#.#.2##
########..#.#####
##...#.#.@#....##
####...#.#.#..#.#
#........####..##
#################