##########%######
####.....#..#..##
###...2.#...#...#
##..L#......###.#
#..#########...##
#.#....M#....#..#
#L##.......######
#....##....#....#
####..##..##.####
##..........#.1##
##..L##...#..#.##
#####......##..##
###L..###....#.##
#####...##L....##
##....###..#.#.##
#@..#...#.###...#
#################