...######..###.
..#...#######..
.##..###..##.#.
#.....###.##.##
#..@...#......#
#....###..##..#
..#..#....##..#
.##.##.#.###..#
.#......##.#..#
.#..+..##.##-.#
.#######......#
..#...#..######
.##.#.#.#.....2
..#.#.#...#.#.#
###############