...######..###.
..#...#######..
.##.L###..##2#.
#.....###.##.##
#..@...#......#
#L...###..##..#
..#..#....##..#
.##.##.#.###..#
.#.....1##.#..#
.#....M##.##..#
.#######.....L#
..#...#..######
.##.#.#.#.....%
..#.#.#...#.#.#
###############