...######..###.
..#...#######..
.##..###..##2#.
#.....###.##.##
#..@...#......#
#....###..##..#
..#..#....##..#
.##.##.#.###..#
.#.....1##.#..#
.#....M##.##..#
.#######......#
..#...#..######
.##.#.#.#.....%
..#.#.#...#.#.#
###############