#%###############
#...##..M#..#.1##
#.##...##..###.##
#....#.#...#...##
####...#.#..##.##
#L.#.#....#....L#
##.#####..#.#####
#......#.....#.##
#####.###.####..#
##M...#...#...###
#...#.#.###.#..##
##..#....##.#..##
###L####..#.#####
##2..#L#..#.L.###
####.#.#....#.#.#
#L...#...#..#...#
###############@#