# # # # # # # # # # # # # # # # # # # # # # # # #
2 . . . . . . . . . . . # . . . . . . . . . . . #
# . # # # # # # # # # . # . # # # # # # # # # . #
# . # . . . . . . . # . # . # . . . . . . . # . #
# . # . # . # # # # # . # . # . # # # # # . # . #
# . # . # . . . . . . . # . # . . . . . # . # . #
# # # . # # # # # # # # # . # # # # # . # . # . #
# . # . # . # . . . . . . . # . . . . . # . # . #
# . # . # . # . # # # # # # # . . # # . # . # . #
# . # . # . # . # . . . . . # . . # . . # . # . #
# . # . # . # . # # # # . # # . . # . . # . # . #
# . # . # . # . # . . # . . . . . # . # # . . . #
# . # . # . # . # . # # . # # # # # # # . # # # #
# . # . . . . . # . . . . # . # . # . . # . . . #
# . # # # # # # # # # . # # # # . # . . # . # . #
# . . . . . . . . . . . # . . . . . . . # . # . #
# . # # # # # # # # # # # . . # # # . . # . # . #
# . # . . . . . . . . . . . . . . # . . # . # . #
# . # . # # # # # # # # # # # # # # . . # . # . #
# . # . . . . . . . . # . . . . . . . . # . # . #
# . # # # # # # # # . # . # # # # # # # # . # . #
# . . . . . . . . . . # . . . . . . . . . . # @ #
# # # # # # # # # # # # # # # # # # # # # # # . #
