#################
#1..........#L.##
#.##...##..###.##
#......#M#.L..#.#
####.....#...####
#.L#......#.....#
##.#####..#.#####
#.M.......#....##
#####L###.####..%
##....#...#...###
#L..#.#.###.#..##
##..#....##.#..##
###.####..#.#####
##2..#L#..#...#L#
####.#.#....#.#.#
#....#...#..#...#
######@##########