#########################
2...........#...........#
#.#########.#.#########.#
#.#.......#.#.#.......#.#
#.#.#.#####.#.#.#####.#.#
#.#.#.......#.#.....#.#.#
###.#########.#####.#.#.#
#.#.#.#.......#.....#.#.#
#.#.#.#.#######..##.#.#.#
#.#.#.#.#.....#..#..#.#.#
#.#.#.#.####.##..#..#.#.#
#.#.#.#.#..#.....#.##...#
#.#.#.#.#.##.#######.####
#.#.....#....#.#.#..#...#
#.#########.####.#..#.#.#
#...........#.......#.#.#
#.###########..###..#.#.#
#.#..............#..#.#.#
#.#.##############..#.#.#
#.#........#........#.#.#
#.########.#.########.#.#
#..........#..........#@#
#######################.#

