###############
####....2.#@..#
#...#......#..#
#.##########..#
##.....#......#
###...........#
######....#...#
###.........###
#..........#.1#
#...#.....#..S#
####..........#
##..........#.#
######.###....#
############M#.
############%##