#########################
%...........#........M..#
#.#########.#.#########.#
#.#.......#.#.#.......#.#
#.#.#.#####.#.#.#####.#.#
#.#.#.......#.#.....#.#.#
###.#########.#####.#.#.#
#.#.#.#..@....#.....#.#.#
#.#.#.#.#######..##.#.#.#
#.#.#.#.#.....#..#..#.#.#
#.#.#.#.####.##..#..#.#.#
#.#.#.#.#..#.....#.##1..#
#.#.#.#.#.##.#######.####
#.#.....#....#.#.#..#...#
#.#########.####.#..#.#.#
#...........#.......#.#.#
#.###########..###..#.#.#
#.#..............#..#.#.#
#.#.##############..#.#.#
#.#........#....2...#.#.#
#.########.#.########.#.#
#..........#..........#.#
#######################.#